b,b,b,b,b,b,b,b,b,b,b,b,b,b,b
b,b,e,e,e,e,e,e,e,e,e,e,e,b,b
b,e,e,t,e,e,e,e,e,e,e,t,e,e,b
b,e,t,e,e,e,e,b,e,e,e,e,e,e,b
b,e,e,e,e,e,e,e,b,e,e,e,e,e,b
d,e,e,e,e,e,e,b,e,e,e,t,e,e,d
b,e,e,e,e,e,e,e,e,e,e,e,e,b,b
b,e,e,e,e,e,e,e,e,e,e,e,e,e,b
b,b,e,t,e,e,e,e,e,e,e,e,e,b,b
b,b,b,b,b,b,b,b,b,b,b,b,b,b,b
e,e,e,e,e,e,e,e,e,e,e,e,e,e,e
