r	r	r	r	r	r	r	r	r	r	r	r	r	r	r
r	r	e	e	r	e	r	e	e	e	r	e	e	r	r
r	e	r	e	e	e	e	r	e	e	e	r	e	e	r
r	e	r	e	e	e	e	e	e	e	e	e	e	e	e
r	e	e	e	e	e	e	e	e	e	e	e	e	e	e
r	e	e	r	e	e	e	r	e	e	e	r	e	e	e
r	e	e	e	e	e	e	e	e	e	e	e	e	r	e
r	e	e	e	e	e	e	e	e	r	e	e	e	e	r
r	r	e	r	e	e	r	e	e	e	e	e	e	r	r
r	r	r	r	r	r	r	r	r	r	r	r	r	r	r